专业技术干部	科技	军事
中保财产保险有限公司农业保险部	保险
中共中华全国供销合作总社党组印发关于进一步加强和改进离退休干部	劳动工会
中共中国科学院党组关于印发中国科学院后备干部	科技
中共中央	文化	反不正当竞争	国家安全	企业	农业	人事	港澳事务	房地产	劳改劳教监所狱政	公安	华侨事务	民事诉讼	宗教事务	国家机关	科技	语言文字	外交外事	劳动工会	民法	机关工作	土地	律师	宪法	财政	财务	民族事务	外商投资企业	改革开放	工商管理	军事	民政	台湾事务	文物文史	教育	统计
中共公安部委员会关于严格执行现役干部	劳动工会
中共国土资源部	宪法	农业	机关工作
中共国家安全监管总局党组关于在处级以上领导干部	国家安全
中共国家测绘地理信息局党组关于转发驻国土资源部	机关工作
中共教育部	劳动工会	人事	军事
中华全国供销合作总社	银行	农业	商贸物资
中华全国工商业联合会	企业
中华全国工商联扶贫与社会服务部	劳动工会
中华全国总工会	劳动工会	企业	外商投资企业
中台办	台湾事务
中国(人民)建设银行关于增设表外科目和调整部	银行
中国(人民)建设银行关于补充外汇科目和调整部	银行
中国互联网络信息中心关于落实工业和信息化部	知识产权
中国人民保险(集团)公司关于印发中国人民保险(集团)公司管理的干部	劳动工会
中国人民保险(集团)公司关于转发金融系统纪检组监察局关于金融系统纪检监察部	机关工作
中国人民保险公司	劳动工会	保险
中国人民建设银行	房地产	气象	银行	劳动工会	财务	票据
中国人民武装警察部	公安	企业	民政	军事
中国人民解放军干部	军事
中国人民解放军总参谋部	军事
中国人民解放军总后勤部	卫生	企业	人事	婚姻赡养收养继承	土地	军事
中国人民解放军总政治部	语言文字	劳改劳教监所狱政	劳动工会	企业	婚姻赡养收养继承	军事	民政	人事
中国人民解放军文职干部	军事
中国人民解放军海军司令部	军事
中国人民解放军退出现役干部	军事
中国人民解放军部政治部	科技
中国人民解放军陆军后勤部	民政
中国人民解放军驻铁路	军事
中国人民银行	咨询	银行	劳动工会	企业	开发区	土地	机关工作	价格	财政	会计	民族事务	港澳事务	房地产	保险	外商投资企业	劳改劳教监所狱政	林业	改革开放	外汇	军事	自由贸易试验区	民事诉讼	证券	对外经贸	科技
中国供销合作经济学会关于发展新会员和拟调整部	商贸物资
中国保险监督管理委员会	保险	统计	检察业务	劳动工会	法制工作
中国共产党军队支部	军事
中国共产党国家海洋局纪律检查委员会	机关工作
中国农业发展银行	农业
中国农业银行	民政	合同	证券	劳动工会	企业	农业	科技
中国国际贸易促进委员会	对外经贸
中国地名委员会	民政	语言文字
中国地震局	地震
中国工商银行	银行	票据	科技
中国工程院办公厅关于召开2007年促进中部	科技
中国工程院办公厅关于召开2008年促进中部	科技
中国建设银行关于下发中国建设银行商业汇票承兑与贴现业务内部	票据
中国建设银行关于下发外汇会计业务手册部	银行
中国建设银行关于印发中国建设银行财会工作达标升级现金出纳部	银行
中国建设银行关于调整部	银行
中国文字改革委员会等部	语言文字
中国残疾人联合会	交通运输	财务
中国残联	文化	教育
中国民用航空局	财务
中国民用航空总局	改革开放
中国气象局	国有资产	水利	气象	卫生
中国注册会计师协会关于吸收中央	会计
中国海事局关于调整海事系统统计报表部	统计
中国煤矿工会代表会议关于废除把头制度向中央人民政府燃料工业部	劳动工会
中国科协	文化	军事	科技	统计
中国科学技术协会	文化	财务	科技	统计
中国科学院	民政	劳动工会	教育	科技
中国结算公司基金业务部	证券
中国统配煤矿总公司关于建立“统配煤矿内部	公司
中国证券登记结算有限责任公司关于2010年部	证券
中国证券登记结算有限责任公司关于2011年部	证券
中国证券登记结算有限责任公司关于2012年部	证券
中国证券登记结算有限责任公司关于2015年部	证券
中国证券登记结算有限责任公司关于2017年部	证券
中国证券登记结算有限责任公司关于中国结算总部	证券
中国证券登记结算有限责任公司关于中国证券登记结算有限责任公司总部	证券
中国证券登记结算有限责任公司关于调整部	证券
中国证券登记结算有限责任公司基金业务部	证券
中国证券监督管理委员会	宪法	公司	证券	地质矿产	企业	期货	律师
中国证监会关于东莞宏远工业区股份有限公司因吸收合并而增加的内部	企业
中国证监会关于中国民族国际信托投资公司上海证券业务部	证券
中国证监会关于中国民族国际信托投资公司北京证券交易营业部	证券
中国证监会关于中国经济开发信托投资公司北京证券交易营业部	证券
中国证监会关于中国经济开发信托投资公司天津证券交易营业部	证券
中国证监会关于中山证券公司北京营业部	证券
中国证监会关于北海国际信托投资公司南宁证券交易营业部	证券
中国证监会关于华夏证券有限公司青岛营业部	证券
中国证监会关于对南方证券哈尔滨营业部	财政
中国证监会关于对期货经纪公司年度报告参考内容与格式做出部	期货
中国证监会关于广东证券股份有限公司受让潮州市信托投资公司所属五家证券营业部	企业
中国证监会关于广东证券股份有限公司受让潮州市信托投资公司深圳证券营业部	企业
中国证监会关于张家界旅游开发股份有限公司内部	企业
中国证监会关于核准东部	外汇
中国证监会关于海南华银国际信托投资公司青岛证券交易营业部	证券
中国证监会关于申银万国证券股份有限公司青岛营业部	证券
中国证监会关于辽宁省建设集团公司	证券
中国证监会关于青岛市弘诚信托投资有限责任公司证券交易营业部	证券
中国证监会期货部	期货
中国银监会办公厅	水利	土地
中国银行	公证	华侨事务	劳改劳教监所狱政	银行	票据	开发区	外汇
中央人民政府法制委员会对内务部	婚姻赡养收养继承
中央军事委员会公告(派驻香港驻军部	军事
中央军委关于做好部	军事
中央军委关于军队转业干部	劳动工会
中央军委关于建立依托普通高等教育培养军队干部	军事
中央军委关于武警部队交通指挥部所属部	军事
中央军委关于确定军队转业干部	劳动工会
中央军委关于给武警水电三峡工程指挥部	公安
中央军委办公厅关于严格控制到云南	军事
中央军委办公厅关于印发军队转业干部	军事
中央军委办公厅关于认真做好驻老山	军事
中央军委办公厅转发国家体委等部	体育
中央军委办公厅转发总参谋部	军事
中央军委办公厅转发教育部	军事
中央军委批转全国拥军优属拥政爱民工作领导小组	军事
中央军委批转劳动保障部等部门关于进一步做好军队干部	劳动工会
中央军委批转国防科工委等部	劳动工会
中央军委批转工商行政管理总局等部	华侨事务	海关
中央军委批转总参谋部	军事
中央军委批转总后勤部	军事
中央军委批转总政治部	军事
中央军委批转教育部	教育
中央军委政治工作部	民政	军事
中央农村工作领导小组办公室	建设业
中央办公厅	人事	机关工作
中央国债登记结算有限责任公司托管部	证券
中央国家机关人民防空委员会关于中央国家机关各部	军事
中央国家机关住房资金管理中心关于落实住房城乡建设部	房地产
中央宣传部	文化	反不正当竞争	语言文字	科技	企业	工商管理	广告	婚姻赡养收养继承	民法	宪法	民政	宗教事务	商贸物资
中央对台工作领导小组办公室	台湾事务	婚姻赡养收养继承
中央对外宣传小组	文化	台湾事务
中央工商行政管理局	劳动工会
中央政法委	检察业务	证券
中央文明办	文化	工商管理	语言文字
中央机构编制委员会办公室	民政	国家机关	劳动工会	对外经贸	统计
中央机构编委会办公室	劳动工会
中央治理党政部	文化
中央法制委员会	婚姻赡养收养继承
中央爱国卫生运动委员会	卫生
中央社会治安综合治理委员会	农业	劳改劳教监所狱政
中央精简小组办公室复关于退休干部	劳动工会
中央纪委	反不正当竞争	民事诉讼	刑事诉讼	审计	劳动工会	人事	机关工作
中央组织部	统计	审计	检察业务	企业	劳动工会	军事
中央统战部	宗教事务	劳动工会	民政	人事
中央综治办	公安	国家安全	劳改劳教监所狱政
中央编办	房地产	科技
中央网络安全和信息化领导小组办公室	公安
中央职称改革工作领导小组	文化	劳动工会	教育
中宣部	文化	语言文字	改革开放	文物文史	教育	科技
中纪委	检察业务	劳动工会	机关工作
中组部	公安	劳动工会	企业	机关工作
中编办	统计
中西部	改革开放	教育
买卖武装部	刑法
交通运输部	语言文字	海事诉讼	外交外事	劳动工会	测绘	民法	土地	机关工作	个体经济	地震	水利	气象	台湾事务	会计	财务	计划	国有资产	保险	对外经贸	交通运输	检察业务	改革开放	卫生	民政	地质矿产	租赁	文物文史	科技	统计
交通部	文化	海事诉讼	企业	水利	会计	保险	劳改劳教监所狱政	检察业务	海关	公证	公安	调解与仲裁	国家机关	科技	语言文字	外交外事	劳动工会	机关工作	土地	价格	宪法	财政	财务	计划	交通运输	工商管理	军事	卫生	民政	合同	公司	地质矿产	台湾事务	对外经贸	商贸物资	统计
产业技术创新战略联盟部	开发区
人事部	企业	开发区	体育	会计	人事	港澳事务	房地产	劳改劳教监所狱政	广告	公安	公证	调解与仲裁	华侨事务	国家机关	科技	语言文字	外交外事	劳动工会	机关工作	土地	价格	仓储	审计	民族事务	外商投资企业	刑事诉讼	改革开放	军事	卫生	法制工作	民政	合同	台湾事务	教育	统计
人力资源和社会保障部	咨询	语言文字	外交外事	劳动工会	企业	开发区	机关工作	体育	价格	地震	水利	气象	审计	会计	人事	港澳事务	保险	工商管理	法制工作	公安	调解与仲裁	民政	民事诉讼	合同	宗教事务	国家机关	台湾事务	教育	科技	统计
人力资源社会保障部	语言文字	劳动工会	测绘	企业	机关工作	宪法	人事	保险	检察业务	工商管理	外汇	军事	公安	民事诉讼	教育	科技
人口计生委关于印发西部	人口与计划生育
人口计生委关于建立全国农村部	人口与计划生育
人口计生委关于调整全国农村部	人口与计划生育
人民检察院侦查监督	检察业务
人民检察院干部	国家机关
人民解放军总后勤部	军事
企业不得为其他部	咨询
会计干部	会计
会计部	银行
住房和城乡建设部	文化	地质矿产	劳动工会	企业	土地	机关工作	个体经济	地震	水利	财务	港澳事务	宗教事务	房地产	对外经贸	交通运输	工商管理	广告	卫生	公司	合同	建设业	国家机关	租赁	文物文史	教育	统计
住房城乡建设部	咨询	国家安全	劳动工会	企业	开发区	个体经济	价格	水利	气象	农业	人事	计划	房地产	对外经贸	交通运输	检察业务	卫生	自由贸易试验区	民政	建设业	租赁	文物文史	教育
体育干部	军事
供销合作总社	价格	劳动工会	商贸物资	军事
供销部门所属单位	咨询
促进中部	改革开放
保卫干部	劳动工会
保密行政管理部	机关工作
保监会	劳动工会
信息产业部	文化	语言文字	知识产权	改革开放	企业	开发区	工商管理	外汇	公安	港澳事务	劳动工会	民事诉讼	气象	计划	科技	统计
修改	军事	财政	会计	银行	企业	民族事务	卫生
停用部	银行
党员领导干部	机关工作
全国中小企业股份转让系统有限责任公司关于全国中小企业股份转让系统2017年部	企业
全国中小企业股份转让系统有限责任公司市场发展部	公司
全国人大常委会关于批准1949年8月12日改善战地武装部	外交外事
全国人大常委会关于批准1949年8月12日改善海上武装部	外交外事
全国人大常委会关于批准和俄罗斯联邦关于举行联合军事演习期间其部	外交外事
全国人大常委会关于授权最高人民法院	刑法	刑事诉讼
全国人大常委会办公厅	机关工作
全国人大教科文卫委员会	语言文字
全国人大法工委	劳改劳教监所狱政
全国人民代表大会常务委员会关于中国人民解放军保卫部门对军队内部	军事
全国供销总社办公厅	商贸物资
全国假日旅游部	统计
全国县级直接选举工作办公室	宪法
全国双拥工作领导小组	地震	国家机关
全国妇联	刑法	机关工作	婚姻赡养收养继承	科技
全国总工会	体育	劳动工会	华侨事务
全国打击侵犯知识产权和制售假冒伪劣商品专项行动领导小组办公室关于做好打击侵犯知识产权和制售假冒伪劣商品专项行动动员部	反不正当竞争
全国打击走私领导小组	海关
全国控办关于防汛部	水利
全国整顿和规范市场经济秩序领导小组办公室	检察业务
全国文物安全工作部际联席会议办公室关于成立全国文物安全工作部	文物文史
全国清理整顿公司领导小组关于中央国家机关各部	机关工作
全国爱卫会	卫生
全国爱国卫生运动委员会	卫生
全国禁毒工作领导小组	财政
全国老龄工作委员会办公室	民政
全国股转公司关于全国股转系统业务支持平台日常业务系统部	企业
全国高教自考委	公安
全总劳动保险部	劳动工会
全民所有制企业聘用制干部	企业
全民科学素质工作领导小组关于转发2006年－2010年领导干部	机关工作
公安部	文化	反不正当竞争	司法协助	国家安全	海事诉讼	企业	体育	水利	农业	人事	港澳事务	行政诉讼	保险	劳改劳教监所狱政	检察业务	旅游	广告	海关	外汇	公安	公证	华侨事务	民事诉讼	证券	宗教事务	国家机关	票据	科技	经济审判	刑法	外交外事	劳动工会	商贸物资	文物文史	律师	机关工作	民法	价格	土地	个体经济	宪法	财政	民族事务	刑事诉讼	外商投资企业	林业	交通运输	改革开放	工商管理	婚姻赡养收养继承	卫生	法制工作	军事	民政	合同	公司	台湾事务	对外经贸	教育	渔业	统计
公寓	外商投资企业
公诉部	检察业务	刑事诉讼
共青团中央	教育	劳动工会	计划	婚姻赡养收养继承	科技	法制工作
关于中央各部	财务
关于加强中央级农口主管部	农业
关于加强预备役部	军事
关于国营企业单位专职武装干部	企业
关于国营建设单位国家预算内基本建设投资全部	会计
关于对道路运输违章处罚规定（试行）中“全部	财政
关于提高粮食销售价格后对城镇部	价格
关于施工	财务
关于煤炭部	能源
关于税务部	能源
关于立即停止审批定向募集股份有限公司并重申停止审批和发行内部	企业
关于进一步做好军队干部	军事
关于进一步解决部	劳动工会
关于邮电部门执行干部	劳动工会
关于部	文化	行政诉讼	劳动工会	广告	土地	外汇	价格	港澳事务	民政	宗教事务	国家机关	计划	科技
关于集体企业实行内部	企业
内务部	劳改劳教监所狱政	劳动工会	婚姻赡养收养继承	土地	军事	体育	民政	华侨事务	气象	教育	统计
内蒙古自治区人民政府关于批准建设省部	资源
内贸部	劳动工会
内部	文化	刑法	劳动工会	价格	审计	会计	财务	保险	刑事诉讼	工商管理	广告	外汇	军事	合同	民事诉讼	国家机关	对外经贸	商贸物资	统计
写字楼（含老饭店改造）需取得国家主管部	外商投资企业
军委总政治部	婚姻赡养收养继承	军事
农业部	文化	国家安全	企业	开发区	体育	水利	气象	会计	农业	港澳事务	国有资产	房地产	保险	海关	广告	公安	调解与仲裁	民事诉讼	建设业	科技	经济审判	渔业	外交外事	劳动工会	土地	机关工作	价格	个体经济	地震	财政	审计	台湾事务	财务	计划	民族事务	牧业	交通运输	知识产权	改革开放	工商管理	法制工作	军事	自由贸易试验区	卫生	民政	合同	资源	对外经贸	教育	商贸物资	统计
农口各部	科技
农垦部	劳动工会	企业
农林部	农业	水利
农牧渔业部	科技	劳动工会	土地	民政	建设业	农业	渔业
冶金工业部	地质矿产	劳动工会	商贸物资
冶金部	商贸物资
分享遗产人能否分得全部	婚姻赡养收养继承
刑事	公安	刑法	刑事诉讼	检察业务	国家机关	劳动工会	经济审判
副省级城市新任科协领导干部	科技
劳动保障部	体育	合同	劳动工会	企业	教育
劳动和社会保障部	外交外事	劳动工会	企业	机关工作	体育	财政	审计	财务	人事	计划	国有资产	行政诉讼	劳改劳教监所狱政	交通运输	卫生	法制工作	军事	公证	调解与仲裁	民政	合同	对外经贸	教育	科技	统计
劳动部	企业	体育	水利	人事	劳改劳教监所狱政	公证	调解与仲裁	华侨事务	科技	刑法	劳动工会	民法	机关工作	个体经济	价格	审计	财务	民族事务	外商投资企业	林业	交通运输	改革开放	工商管理	军事	卫生	民政	合同	地质矿产	台湾事务	对外经贸	教育	统计
劳改工作干部	劳动工会
劳教工作移交给司法行政部	劳改劳教监所狱政
劳教系统所级领导干部	劳改劳教监所狱政
劳教部	劳改劳教监所狱政
化学工业部	咨询	机关工作	企业	标准化管理和认证认可	科技	港澳事务
化工部	文化	计量	外商投资企业	劳动工会	企业	期货	标准化管理和认证认可	机关工作	地质矿产	财务	计划	教育	科技	统计
北京商业管理干部	商贸物资
北京市人民政府	文化
北京市民政局	民政
区)人民武装部改归地方建制后干部	劳动工会
华侨事务委员会	华侨事务	劳改劳教监所狱政
卫生部	文化	反不正当竞争	计量	企业	体育	水利	人口与计划生育	会计	人事	港澳事务	行政诉讼	劳改劳教监所狱政	检察业务	广告	公证	民事诉讼	科技	刑法	劳动工会	机关工作	价格	地震	财政	财务	民族事务	计划	外商投资企业	刑事诉讼	改革开放	工商管理	婚姻赡养收养继承	卫生	军事	民政	合同	台湾事务	教育	商贸物资	统计
危险品运输专用船由部	海关
县工商行政管理部	企业
发展改革委	咨询	反不正当竞争	司法协助	企业	开发区	水利	人事	农业	港澳事务	外汇	公安	建设业	科技	劳动工会	律师	土地	个体经济	价格	仓储	台湾事务	财务	计划	民族事务	改革开放	知识产权	卫生	自由贸易试验区	法制工作	民政	合同	地质矿产	资源	教育	统计
司法部	文化	反不正当竞争	咨询	国家安全	司法协助	企业	水利	人事	港澳事务	国有资产	房地产	行政诉讼	保险	劳改劳教监所狱政	检察业务	海关	外汇	公证	公安	调解与仲裁	华侨事务	民事诉讼	证券	建设业	宗教事务	国家机关	语言文字	刑法	外交外事	劳动工会	民法	土地	机关工作	价格	律师	个体经济	宪法	地震	财务	民族事务	计划	刑事诉讼	林业	改革开放	婚姻赡养收养继承	法制工作	军事	卫生	民政	合同	公司	台湾事务	教育	统计
商业部	咨询	反不正当竞争	计量	企业	水利	国有资产	房地产	行政诉讼	保险	劳改劳教监所狱政	旅游	外汇	公安	华侨事务	租赁	票据	科技	语言文字	外交外事	银行	劳动工会	律师	机关工作	民法	价格	个体经济	财政	仓储	审计	财务	民族事务	计划	对外经贸	改革开放	工商管理	婚姻赡养收养继承	军事	法制工作	民政	公司	合同	资源	文物文史	教育	商贸物资
商务部	文化	反不正当竞争	国家安全	企业	开发区	测绘	水利	会计	农业	人事	港澳事务	国有资产	房地产	保险	检察业务	海关	外汇	调解与仲裁	国家机关	科技	外交外事	劳动工会	期货	民法	土地	机关工作	价格	文物文史	地震	仓储	审计	民族事务	计划	外商投资企业	刑事诉讼	交通运输	改革开放	知识产权	工商管理	卫生	自由贸易试验区	民政	公司	合同	台湾事务	对外经贸	教育	商贸物资	统计
商品住宅装修一次到位材料	房地产
四川省	刑事诉讼
团体	房地产	民法
国内贸易部	劳动工会	企业	律师	机关工作	价格	仓储	审计	计划	国有资产	劳改劳教监所狱政	工商管理	军事	公司	合同	租赁	商贸物资
国办＜关于进一步治理党政部	文化
国务院	反不正当竞争	企业	开发区	测绘	体育	会计	港澳事务	国有资产	外汇	公安	华侨事务	建设业	国家机关	科技	特区	劳动工会	机关工作	价格	财政	民族事务	交通运输	能源	公司	合同	地质矿产	资源	对外经贸	教育	商贸物资	统计	文化	国家安全	渔业	水利	气象	人事	农业	房地产	检察业务	标准化管理和认证认可	海关	民事诉讼	证券	宗教事务	语言文字	外交外事	期货	土地	个体经济	地震	宪法	审计	财务	计划	外商投资企业	林业	改革开放	工商管理	婚姻赡养收养继承	军事	法制工作	卫生	民政	台湾事务	文物文史
国土资源部	文化	国家安全	开发区	水利	会计	农业	国有资产	房地产	行政诉讼	检察业务	公安	华侨事务	民事诉讼	建设业	租赁	科技	劳动工会	土地	机关工作	价格	个体经济	地震	宪法	财政	外商投资企业	改革开放	工商管理	民政	合同	地质矿产	台湾事务	文物文史	教育	统计
国家中医药局	教育
国家中医药管理局	文化	广告	科技	军事
国家互联网信息办公室	公安
国家交通战备办公室	军事
国家人事局	公安	劳动工会	华侨事务	科技
国家人防委	军事
国家体委	体育	劳动工会
国家体改委	外商投资企业	劳动工会	企业	国有资产	商贸物资
国家体育总局	体育	个体经济	教育	机关工作	统计
国家体育运动委员会	体育
国家保密局	机关工作
国家农业综合开发办公室	劳改劳教监所狱政
国家劳动总局	公安	民政	华侨事务	劳动工会	企业	教育	个体经济
国家医药管理局	劳动工会	卫生
国家南极考察委员会	劳动工会
国家卫生和计划生育委员会	价格	反不正当竞争	保险
国家发展和改革委员会	反不正当竞争	地质矿产	劳动工会	企业	开发区	土地	价格	地震	水利	人事	农业	计划	房地产	交通运输	改革开放	旅游	工商管理	外汇	公安	卫生	民政	建设业	台湾事务	教育	科技
国家发展计划委员会	价格	统计	企业	检察业务	财务	农业	海关	卫生
国家发改委	水利
国家国有资产管理局	房地产	企业	土地	外汇	公证	财务	国有资产	统计
国家土地管理局	土地	军事
国家城市建设总局	企业	个体经济
国家外国专家局	劳动工会
国家外汇管理局	房地产	保险	宗教事务	租赁	对外经贸	外汇
国家安全生产应急救援指挥中心综合部	国家安全
国家安全生产监督管理局	商贸物资
国家安全生产监督管理总局	国家安全	劳动工会	教育
国家安全监管总局	国家安全	合同	地质矿产	劳动工会
国家安全部	国家安全	刑事诉讼	外交外事	劳动工会	检察业务	婚姻赡养收养继承	法制工作	公安	民政	民事诉讼
国家宗教事务局	宗教事务
国家宗教局	宗教事务
国家工商局	合同
国家工商总局	价格	体育	合同	外商投资企业	工商管理	军事
国家工商行政管理局	文化	反不正当竞争	企业	期货	个体经济	价格	财政	保险	外商投资企业	对外经贸	工商管理	海关	广告	婚姻赡养收养继承	军事	外汇	公安	民政	合同	公司	文物文史
国家工商行政管理总局	文化	刑法	企业	测绘	律师	个体经济	财务	农业	房地产	外商投资企业	工商管理	广告	军事	外汇	公安	台湾事务	商贸物资
国家广播电影电视总局	语言文字
国家广电总局办公厅	教育
国家建委	房地产	财务
国家建材工业局	计划
国家建筑材料工业局	企业
国家开发银行分行资产管理部	银行
国家技术监督局	价格	工商管理
国家教委	文化	语言文字	劳改劳教监所狱政	劳动工会	企业	法制工作	卫生	公安	军事	港澳事务	国家机关	台湾事务	教育	科技
国家教育委员会	语言文字	劳动工会	军事	体育	卫生	教育	科技
国家文物局	财政	文物文史	建设业	开发区	土地	统计
国家新闻出版广电总局	文化	民族事务
国家旅游局	外交外事	劳动工会	旅游
国家机关各部	会计
国家机关离休干部	劳动工会
国家林业局	公安	刑事诉讼	林业	财务	农业
国家档案局	建设业	军事
国家森林防火指挥部	证券
国家民委	体育	民政	建设业	企业	民族事务	教育
国家民族事务委员会	民族事务
国家气象局	劳动工会	气象
国家测绘地理信息局地理信息与地图司关于在公开地图上调整河北省唐山市部	民政
国家测绘局	测绘	教育
国家海洋局关于贯彻执行关于适当调整国家机关和部	劳动工会
国家烟草专卖局	公安	财政	民法	企业	海关	商贸物资
国家煤矿安全监察局	劳动工会
国家版权局	公安	文化
国家物价局	文化	房地产	外交外事	科技	劳动工会	企业	婚姻赡养收养继承	土地	机关工作	公证	价格	合同	财务	国有资产	统计
国家物价总局	民族事务
国家物资局	林业
国家物资总局	房地产	劳动工会
国家物资管理总局关于物资系统供应国家房管部	房地产
国家环保局关于继续在部	计划
国家环保局离退休干部	劳动工会
国家环境保护局关于县级环境保护部	财政
国家环境保护总局	改革开放	财政	机关工作
国家监察部	土地
国家知识产权局	反不正当竞争	知识产权	教育
国家科委	企业	计划	科技
国家科学技术委员会	科技
国家税务局	房地产	外商投资企业	刑法	企业	土地	外汇	财政	商贸物资	统计
国家税务总局	房地产	外交外事	科技	改革开放	企业	劳动工会	交通运输	外汇	合同	财务	国有资产
国家粮食储备局	农业	军事
国家粮食局	价格
国家经委	咨询	林业	外商投资企业	劳动工会	企业	工商管理	公安	民政	证券	财务
国家经济体制改革委员会	改革开放	企业	民政
国家经济委员会	劳动工会	企业	劳改劳教监所狱政
国家经济贸易委员会	国家安全	劳动工会	企业	商贸物资	律师	价格	财政	计划	外商投资企业	交通运输	改革开放	工商管理	海关	外汇	地质矿产	对外经贸	科技	统计
国家经贸委	房地产	外商投资企业	对外经贸	劳动工会	企业	标准化管理和认证认可	海关	土地	外汇	工商管理	改革开放	民族事务	商贸物资	统计
国家经贸等四部	租赁
国家统计局	统计	企业	农业	外汇	军事
国家能源局	建设业
国家药品监督管理局	文化	反不正当竞争	企业	广告	卫生
国家药监局	广告
国家西部大学校园网项目领导小组办公室关于加强对西部	科技
国家西部大学校园网项目领导小组办公室关于西部	科技
国家计划委员会	房地产	劳改劳教监所狱政	劳动工会	企业	改革开放	财政	合同	人事	国家机关	农业	教育	统计
国家计划生育委员会	开发区	婚姻赡养收养继承	人口与计划生育
国家计委	咨询	计量	企业	水利	气象	农业	房地产	劳改劳教监所狱政	标准化管理和认证认可	公证	公安	国家机关	科技	劳动工会	律师	土地	个体经济	价格	财政	财务	计划	林业	交通运输	改革开放	知识产权	工商管理	婚姻赡养收养继承	法制工作	军事	合同	公司	地质矿产	台湾事务	文物文史	教育	商贸物资	统计
国家计量局	科技
国家认监委	国家机关
国家认证认可监督管理委员会	国家安全	国家机关
国家证券委关于江苏省证券公司盐城业务部	证券
国家语委科研规划领导小组办公室关于印发教育部	语言文字
国家语言文字工作委员会	民政	语言文字
国家质检总局	标准化管理和认证认可	卫生
国家质量监督检验检疫总局	价格	计量	计划	工商管理	审计	外交外事	对外经贸	卫生
国家邮政局	国家安全
国家防总办公室	水利
国家防汛总指挥部	水利
国家防汛抗旱总指挥部	水利	气象
国家食品药品监督管理局	体育	文化	司法协助	广告
国有资产监督管理委员会	劳改劳教监所狱政
国管局关于调整中央国家机关去世离休干部	劳动工会
国管局关于调整中央在京企业住房公积金主管部	房地产
国管局办公室	统计
国资委	企业
国防科学技术工业委员会关于印发关于原军工总公司机关	劳动工会
国防科工委	科技	军事
国防科工局	军事
国防部	劳动工会	劳改劳教监所狱政	军事
土地管理部	土地	机关工作
地方政府和部	法制工作
地矿部	工商管理	地震	公司	地质矿产	统计
地质矿产部	地质矿产	劳动工会	公司	法制工作
地质部	地质矿产	劳动工会
城乡建设环境保护部	房地产	劳动工会	开发区	工商管理	土地	卫生	民法	军事	民政	公司	水利	建设业
城乡建设部	军事
复员军人曾在部	劳动工会
外交部	文化	国家安全	司法协助	外交外事	刑法	劳动工会	测绘	民法	机关工作	价格	地震	房地产	刑事诉讼	对外经贸	改革开放	旅游	工商管理	婚姻赡养收养继承	外汇	公证	军事	华侨事务	民事诉讼	宗教事务	国家机关	台湾事务	文物文史	教育	科技
外经贸部	价格	外商投资企业	交通运输	劳动工会	台湾事务	对外经贸	科技	外汇
外贸易经济合作部	对外经贸
外贸部	计量
审计署	财政	审计	劳动工会	财务	土地
对外经济贸易合作部	外商投资企业	交通运输	国有资产	外汇	对外经贸	港澳事务
对外经济贸易部	外交外事	租赁	劳动工会	企业	价格	仓储	审计	会计	国有资产	港澳事务	保险	外商投资企业	改革开放	工商管理	海关	外汇	华侨事务	公司	合同	台湾事务	对外经贸	统计
对外经贸合作部	咨询
对外贸易与经济合作部	房地产	劳动工会	企业	开发区	教育
对外贸易经济合作部	文化	反不正当竞争	企业	开发区	会计	港澳事务	国有资产	房地产	保险	标准化管理和认证认可	海关	外汇	科技	外交外事	银行	劳动工会	期货	律师	机关工作	价格	仓储	审计	财务	计划	外商投资企业	交通运输	改革开放	工商管理	民政	合同	公司	地质矿产	台湾事务	对外经贸	统计
对外贸易部	海关	外汇
对短期出口信用保险业务管理规定理赔	保险
小学干部	教育
山西省委支部	民事诉讼
工业和信息化部	文化	反不正当竞争	国家安全	司法协助	企业	开发区	体育	水利	会计	人事	农业	港澳事务	检察业务	标准化管理和认证认可	广告	外汇	公安	证券	建设业	科技	劳动工会	机关工作	个体经济	价格	仓储	财务	计划	对外经贸	交通运输	改革开放	知识产权	工商管理	军事	卫生	合同	地质矿产	文物文史	商贸物资	统计
工信部	国家安全
工商总局	公安
工商行政管理总局	个体经济
工商行政管理部	合同	民事诉讼	工商管理	商贸物资	经济审判
市	劳动工会	知识产权	企业	民法	民事诉讼	合同	国家机关	票据	经济审判
广东国际信托投资公司深圳公司上海证券营业部	证券
广发证券公司上海业务部	证券
广播电影电视部	文化	语言文字	改革开放	企业	广告	卫生	体育	审计	会计	台湾事务	人事	教育	科技	统计
广播电视部	劳动工会
广电总局	公安
广西前线部	军事
广西壮族自治区人民政府关于批准建设省部	科技
建筑工程部	劳动工会
建设部	文化	企业	开发区	水利	会计	港澳事务	国有资产	房地产	保险	劳改劳教监所狱政	检察业务	公证	公安	华侨事务	民事诉讼	建设业	科技	特区	外交外事	劳动工会	文物文史	民法	土地	机关工作	价格	个体经济	地震	财务	计划	外商投资企业	交通运输	改革开放	工商管理	婚姻赡养收养继承	卫生	法制工作	军事	民政	合同	公司	对外经贸	教育	商贸物资	统计
建设部房地产业司中国人民解放军总后勤部基建营房部	房地产
开林业公路	土地
律师费留归司法行政部	公证	律师
总参谋部	体育	民政	合同	外交外事	劳动工会	土地	军事
总参通信部	军事
总后勤部	房地产	劳动工会	土地	军事	价格	民政	计划	人事	商贸物资
总政治关于军队刑满释放干部	民政
总政治部	房地产	劳动工会	婚姻赡养收养继承	法制工作	体育	军事	公安	民政	水利	人事
总政部办公厅关于边防	军事
总装备部	科技	军事
扶贫部	检察业务
批发企业放调部	审计
技术改造项目部	财务
提前退休工种核工业部安全防护卫生局核工业部	劳动工会
提高吸收外资水平	改革开放
政务院关于变更国家建设征用土地办法中部	土地
政务院关于批准中央贸易部	民族事务
教育部	文化	国家安全	测绘	开发区	体育	水利	气象	会计	国有资产	劳改劳教监所狱政	检察业务	外汇	公安	华侨事务	建设业	科技	语言文字	刑法	外交外事	劳动工会	土地	机关工作	地震	宪法	民族事务	计划	婚姻赡养收养继承	卫生	军事	民政	合同	文物文史	教育	商贸物资	统计
文化部	文化	反不正当竞争	国家安全	语言文字	劳动工会	企业	机关工作	会计	民族事务	计划	港澳事务	婚姻赡养收养继承	公证	自由贸易试验区	公安	建设业	文物文史	教育	科技	统计
文物局等部	文物文史
文职干部	劳动工会	军事
文艺	军事
新技术企业部	科技
新闻出版总署	文化	测绘	教育
新闻出版署	文化	反不正当竞争	外商投资企业	刑法	教育
最高人民检察署	公安	民事诉讼
最高人民检察院	刑法	外交外事	劳动工会	律师	机关工作	价格	宪法	财政	会计	行政诉讼	刑事诉讼	劳改劳教监所狱政	林业	检察业务	婚姻赡养收养继承	法制工作	公安	军事	民政	民事诉讼	证券	宗教事务	国家机关	商贸物资	经济审判
最高人民法院	国家安全	反不正当竞争	司法协助	海事诉讼	企业	房地产	行政诉讼	劳改劳教监所狱政	检察业务	海关	公证	公安	调解与仲裁	华侨事务	民事诉讼	证券	宗教事务	国家机关	票据	经济审判	刑法	外交外事	劳动工会	律师	民法	宪法	财政	刑事诉讼	工商管理	婚姻赡养收养继承	法制工作	军事	卫生	民政	合同	商贸物资
最高人法院关于在审理经济纠纷案件中发现经济犯罪问题后移送有关部	经济审判
最高检察院	劳改劳教监所狱政
最高法院	劳改劳教监所狱政
期货营业部	期货
朱良发	民法
机关工作人员牺牲	民政
机械工业部	财务	改革开放	企业	标准化管理和认证认可	科技
机械电子工业部	特区	财政
机械电子部	工商管理
机械部	对外经贸	劳动工会	标准化管理和认证认可	科技
机电部	文化	会计	计划	律师	科技
村团支部	科技
林业部	林业	知识产权	劳动工会	企业	公安	财政	水利	国家机关	农业	科技
核工业部地质局关于科学技术干部	科技
检察	国家机关
武警总部	国家安全	劳改劳教监所狱政
武警部	公安	经济审判	国家机关	劳动工会	企业	军事
民政部	文化	反不正当竞争	企业	体育	水利	会计	农业	人事	港澳事务	房地产	行政诉讼	保险	劳改劳教监所狱政	检察业务	外汇	公证	公安	华侨事务	民事诉讼	证券	宗教事务	建设业	国家机关	科技	语言文字	刑法	外交外事	劳动工会	律师	机关工作	价格	地震	宪法	财政	财务	民族事务	林业	对外经贸	交通运输	改革开放	工商管理	婚姻赡养收养继承	军事	卫生	法制工作	民政	合同	台湾事务	文物文史	教育	商贸物资	统计
民航总局	对外经贸	财政	军事
气象科学研究干部	气象
气象部	科技	劳动工会	气象
水利电力部	计量	水利	合同	科技	劳动工会	农业	机关工作
水利部	文化	劳动工会	土地	个体经济	价格	地震	水利	会计	财务	人事	农业	计划	检察业务	民政	建设业	科技	统计
江西省人民政府关于批准建设省部	科技
沈珍珠诉青春编辑部	民法
油船	海关
治安民警改为干部	公安
法制办	宪法
法院部	国家机关
浙江省委统战部	劳动工会
海关公告（对部分企业	海关
海关公告－－指定口岸进口维修用汽车车身的部	海关
海关总署	反不正当竞争	外交外事	测绘	开发区	企业	价格	财政	国有资产	外商投资企业	改革开放	海关	公安	华侨事务	台湾事务	对外经贸	教育	渔业	统计
海军司令部	调解与仲裁
海岛部	军事
消防部	民政
液化气船	海关
清理烟草行业领导干部	企业	民法
煤炭工业部	文化	合同	地质矿产	劳动工会	民法
煤炭部	劳动工会	测绘	合同	财务	教育
煤电油气运保障工作部	个体经济
燃料工业部	劳动工会
物资部	改革开放	企业	工商管理	价格	公司	合同	审计	地质矿产	会计	仓储	计划	商贸物资
环境保护部	文化	司法协助	地质矿产	开发区	机关工作	个体经济	地震	水利	仓储	农业	计划	保险	刑事诉讼	改革开放	海关	卫生	民事诉讼	证券	建设业	教育	科技	统计
甘肃省高级人民法院核准部	刑事诉讼
电力工业部	刑法	劳动工会	企业	改革开放	海关	个体经济	民政	合同	水利	会计	财务	教育	科技
电力工业部关于离退休干部	劳动工会
电力工业部离退休干部思想政治工作暂行办法	劳动工会
电力部	劳动工会	企业	改革开放	会计	财务
留学人员回国服务工作部际联席会议关于印发留学人员回国服务工作部	教育
病故	民政	军事
监察局关于召开部	机关工作
监察局关于委托部分省社纪检监察部	商贸物资
监察部	文化	国家安全	刑法	劳动工会	企业	律师	土地	机关工作	价格	宪法	财政	审计	会计	财务	人事	农业	国有资产	房地产	检察业务	工商管理	法制工作	公安	国家机关	商贸物资	统计
直属机关事务管理局关于贯彻落实在京中央和国家机关部级干部	房地产
知识产权行业标准－－专利信息统计数据项标准(第一部	统计
福建省人民政府关于处理党政干部	土地
科学技术干部	科技
科学技术部	国家安全	文化	劳动工会	企业	开发区	机关工作	地震	财政	农业	计划	保险	外商投资企业	改革开放	合同	建设业	科技	统计
科学文教卫生等部门部	劳动工会
科技部	房地产	交通运输	测绘	标准化管理和认证认可	开发区	卫生	外汇	公安	地震	民政	资源	计划	教育	科技
第一轻工业部	保险
粮食	咨询	劳动工会	企业	军事	价格	个体经济	民政	农业
纺织工业部	价格	劳动工会	合同
纺织部	计量	计划	军事
经贸委	统计
经贸部	外商投资企业	语言文字	交通运输	工商管理	价格	公证	计划	华侨事务	台湾事务	对外经贸
统战部	劳动工会	民政	财务
统计干部	统计
老干部	劳动工会	民政	港澳事务
者阴山前线部	军事
能源部	文化	特区	劳动工会	企业	土地	法制工作	能源	地震	民政	水利	合同	科技	统计
自治区	改革开放	外商投资企业
航空工业部	科技
被工商部	劳动工会
解决企业工资拖欠问题部	劳动工会
解放区入党的农村党员，1949年1月至9月提拔为享受薪金制待遇的脱产干部	劳动工会
计委	统计
证监会	企业	期货	合同
财政部	咨询	反不正当竞争	计量	司法协助	企业	开发区	体育	人口与计划生育	会计	国有资产	港澳事务	保险	旅游	广告	外汇	公证	公安	调解与仲裁	华侨事务	建设业	国家机关	租赁	科技	特区	刑法	银行	劳动工会	律师	机关工作	价格	财政	仓储	民族事务	交通运输	自由贸易试验区	能源	合同	公司	地质矿产	资源	对外经贸	教育	商贸物资	统计	文化	国家安全	水利	气象	农业	人事	房地产	劳改劳教监所狱政	检察业务	海关	民事诉讼	证券	宗教事务	票据	外交外事	期货	民法	土地	个体经济	地震	宪法	审计	财务	计划	牧业	外商投资企业	林业	改革开放	知识产权	工商管理	婚姻赡养收养继承	卫生	法制工作	军事	民政	台湾事务	文物文史
轻工业部	文化	国家安全	科技	劳动工会	企业	军事	价格	证券	计划	商贸物资
轻工总会	商贸物资
轻工部	商贸物资
辽宁金帝建设集团股份有限公司	证券
进出口管理委员会	外汇
进口汽车零部	海关
追偿部	保险
退休干部	劳动工会
退职条件及加强干部	劳动工会
邮电一级干线基本建设	财务
邮电干部	机关工作
邮电部	文化	刑法	银行	劳动工会	企业	民法	机关工作	价格	地震	水利	审计	会计	财务	计划	劳改劳教监所狱政	改革开放	工商管理	军事	合同	台湾事务	科技	统计
部	房地产	劳动工会	工商管理	海关	民法	军事	机关工作	统计	票据	科技	经济审判
铁道部	语言文字	刑法	劳动工会	企业	商贸物资	民法	机关工作	土地	价格	财政	水利	会计	财务	人事	农业	房地产	保险	刑事诉讼	交通运输	改革开放	军事	公安	卫生	民政	合同	国家机关	教育	科技	统计
食品药品监管局	体育
